▤▤▤▤▤▤▤▤▤▤▤▤▤▤▤▤▤▤▤▤▤▤▤▤▤▤▤▤▤▤▤▤▤▤▤▤▤▤▤▤▤▤▤▤▤▤▤▤▤▤▤▤▤▤▤▤▤▤▤▤▤▤▤▤▤▤▤▤▤▤▤▤▤▤▤▤▤▤▤▤
▤♣♣♣♣♣♣♣♣♣♣♣♣♣♣▤             ▤                 ▤   ▤▤     ▤      ▤   ▤   ▤    ▤▤
▤♣♣♣▤▤▤▤                     ▤                            ▤                    ▤
▤♣♣♣▤▤▤▤                                                     ▤▤▤▤▤▤▤▤▤▤▤▤▤▤▤▤▤▤▤
▤                            ▤             ♣              ▤                    ▤
▤♣♣♣                         ▤             ♣                                   ▤
▤♣♣♣♣    ▤▤▤▤▤▤▤▤            ▤                            ▤                    ▤
▤ ♣♣♣♣   ▤      ▤            ▤                            ▤                    ▤
▤  ♣     ▤      ▤            ▤                            ▤     ♣♣♣♣♣♣♣♣♣♣♣♣♣♣♣▤
▤        ▤      ▤▤▤▤▤▤▤▤▤▤▤  ▤                            ▤       ♣♣♣♣♣♣♣♣♣♣♣♣♣▤
▤   ☺♣   ▤                   ▤               ☠            ▤                    ▤
▤        ▤                   ▤                            ▤                    ▤
▤        ▤▤▤▤▤▤▤▤▤▤▤▤▤▤▤▤▤▤▤▤▤                            ▤                    ▤
▤                            ▤              •             ▤                    ▤
▤                  ♣♣♣       ▤           •                ▤                    ▤
▤                   ♣        ▤             •              ▤                    ▤
▤  ▤▤▤▤▤▤▤▤▤▤▤▤▤▤▤▤▤▤▤▤▤▤▤   ▤              •             ▤                    ▤
▤  ▤                     ▤   ▤              •             ▤                    ▤
▤  ▤                     ▤ ☠ ▤             •              ▤                    ▤
▤  ▤                     ▤   ▤              •             ▤▤▤▤▤▤▤▤▤▤▤▤▤▤▤▤▤▤▤▤ ▤
▤  ▤                     ▤▤▤▤▤              •             ▤       ♣♣♣♣♣♣♣♣♣♣♣♣♣▤
▤  ▤                         ▤              •             ▤      ♣♣♣♣♣♣♣♣♣♣♣♣♣♣▤
▤  ▤                         ▤                            ▤    ♣♣♣♣♣♣♣♣♣♣♣♣♣♣♣♣▤
▤  ▤  ▤▤▤▤▤▤▤▤▤▤▤▤▤▤▤▤▤▤▤▤▤▤▤▤            ♣♣♣♣♣♣          ▤   ♣♣♣♣♣♣♣♣♣♣♣♣♣♣♣♣♣▤
▤  ▤                         ▤             ♣♣♣♣           ▤♣♣♣♣♣♣♣♣♣♣♣♣♣♣♣♣♣♣♣♣▤
▤  ▤                         ▤                            ▤♣♣♣♣♣♣♣♣♣♣♣♣♣♣♣♣♣♣♣♣▤
▤  ▤                         ▤                            ▤♣♣♣♣♣♣♣♣♣♣♣♣♣♣♣♣♣♣♣♣▤
▤  ▤                         ▤                            ▤♣♣♣♣♣♣♣♣♣♣♣♣♣♣♣♣♣♣♣♣▤
▤                            ▤                            ▤♣♣♣♣♣♣♣♣♣♣♣♣♣♣♣♣♣♣♣♣▤
▤▤▤▤▤▤▤▤▤▤▤▤▤▤▤▤▤▤▤▤▤▤▤▤▤▤▤▤▤▤▤▤▤▤▤▤▤▤▤▤▤▤▤▤▤▤▤▤▤▤▤▤▤▤▤▤▤▤▤▤▤▤▤▤▤▤▤▤▤▤▤▤▤▤▤▤▤▤▤▤