▤▤▤▤▤▤▤▤▤▤▤▤▤▤▤▤▤▤▤▤▤▤▤▤▤▤▤▤▤▤▤▤▤▤▤▤▤▤▤▤▤▤▤▤▤▤▤▤▤▤▤▤▤▤▤▤▤▤▤▤▤▤▤▤▤▤▤▤▤▤▤▤▤▤▤▤▤▤▤▤
▤                                                                              ▤
▤    ♣      ♣      ♣      ♣      ♣      ♣      ♣      ♣      ♣      ♣      ♣   ▤
▤   ♣   ▤  ♣      ♣      ♣      ▤      ♣    ▤ ♣      ♣  ▤   ♣      ♣▤     ♣    ▤
▤  ♣    ▤ ♣      ♣      ♣      ♣▤     ♣     ▤♣      ♣   ▤  ♣      ♣ ▤    ♣     ▤
▤ ♣     ▤♣      ♣      ♣      ♣ ▤    ♣      ▤      ♣    ▤ ♣      ♣  ▤   ♣      ▤
▤       ▤      ♣      ♣      ♣  ▤   ♣      ♣▤     ♣     ▤♣      ♣   ▤  ♣       ▤
▤      ♣▤     ♣      ♣      ♣   ▤  ♣      ♣ ▤    ♣      ▤      ♣    ▤ ♣      ♣ ▤
▤     ♣ ▤    ♣      ♣      ♣    ▤ ♣      ♣  ▤   ♣      ♣▤     ♣     ▤♣      ♣  ▤
▤    ♣  ▤   ♣      ♣      ♣     ▤♣      ♣   ▤  ♣      ♣ ▤    ♣      ▤      ♣   ▤
▤   ♣   ▤  ♣      ♣      ♣      ▤      ♣    ▤ ♣      ♣  ▤   ♣      ♣▤     ♣    ▤
▤  ♣    ▤ ♣      ♣      ♣      ♣▤     ♣     ▤♣      ♣   ▤  ♣      ♣ ▤    ♣     ▤
▤ ♣     ▤♣      ♣      ♣      ♣▤▤▤▤▤▤♣      ▤▤▤▤▤▤ ♣    ▤ ♣      ♣  ▤   ♣      ▤
▤       ▤      ♣      ♣      ♣      ♣      ♣      ♣     ▤♣      ♣   ▤  ♣       ▤
▤      ♣▤     ♣      ♣      ♣      ♣    ☠ ♣      ♣      ▤      ♣    ▤ ♣      ♣ ▤
      ♣ ▤    ♣      ♣      ♣      ♣      ♣      ♣      ♣▤     ♣     ▤♣      ♣   
▤    ♣  ▤   ♣      ♣      ♣      ♣      ♣      ♣      ♣ ▤    ♣      ▤      ♣   ▤
▤   ♣   ▤  ♣      ♣      ♣     ▤▤▤▤▤▤▤▤▤▤▤▤▤▤▤▤▤▤▤   ♣  ▤   ♣      ♣▤     ♣    ▤
▤  ♣    ▤ ♣      ♣      ♣      ♣▤     ♣     ▤♣      ♣   ▤  ♣      ♣ ▤    ♣     ▤
▤ ♣     ▤♣      ♣      ♣      ♣ ▤    ♣      ▤      ♣    ▤ ♣      ♣  ▤   ♣      ▤
▤       ▤      ♣      ♣      ♣  ▤   ♣      ♣▤     ♣     ▤♣      ♣   ▤  ♣       ▤
▤      ♣▤     ♣      ♣      ♣   ▤  ♣      ♣ ▤    ♣      ▤      ♣    ▤ ♣      ♣ ▤
▤     ♣ ▤    ♣      ♣      ♣    ▤ ♣      ♣  ▤   ♣      ♣▤     ♣     ▤♣      ♣  ▤
▤    ♣  ▤   ♣      ♣      ♣     ▤♣      ♣   ▤  ♣      ♣ ▤    ♣      ▤      ♣   ▤
▤   ♣      ♣      ♣      ♣      ♣      ♣      ♣      ♣      ♣      ♣      ♣    ▤
▤  ♣☺     ♣      ♣      ♣      ♣      ♣      ♣      ♣      ♣      ♣      ♣     ▤
▤ ♣      ♣      ♣      ♣      ♣      ♣      ♣      ♣      ♣      ♣      ♣      ▤
▤       ♣      ♣      ♣      ♣      ♣      ♣      ♣      ♣      ♣      ♣       ▤
▤                                                                              ▤
▤▤▤▤▤▤▤▤▤▤▤▤▤▤▤▤▤▤▤▤▤▤▤▤▤▤▤▤▤▤▤▤▤▤▤▤▤▤▤▤▤▤▤▤▤▤▤▤▤▤▤▤▤▤▤▤▤▤▤▤▤▤▤▤▤▤▤▤▤▤▤▤▤▤▤▤▤▤▤▤